%%%%%%%%%%%%%%%%%%%%%%%%%%%%%%%%%%%%%%%%%%%%%%
%............................................%
%............................................%
%.................................#######....%
%....##..........................##.....#....%
%...####......######.............#...........%
%...####.....................#...#...........%
%............................#..#............%
%...........................#...#....#.......%
%..............###.###......#...##....##.....%
%..........................#...........#.....%
%..........................#...........#.....%
|.........................#............#.....|
%.........................#..................%
%.........###....................###.........%
%.........###......................#.........%
%...................................#........%
%...................................#........%
%.....................#.............#........%
%.....................#.............#........%
%.....................###..........##........%
%.......................###..................%
%............................................%
%............................................%
%%%%%%%%%%%%%%%%%%%%%%%%%%%%%%%%%%%%%%%%%%%%%%
