#########################
#.......................#
#.......................#
#.......................#
#....%..................#
#....%..................#
#....%...........%......#
#....%%.........%%......#
#....%%.........%%......#
#....%%.........%%......#
|@...%%....!....%%.!....|
#....%%.........%%......#
#....%%.........%%......#
#....%..........%.......#
#....%..................#
#....%..................#
#.......................#
#.......................#
#.......................#
#.......................#
#########################
