#########################
#.......................#
#.......................#
#.......................#
#.......................#
#......%%%..............#
#......%%%........%%....#
#.......%%.......%%%....#
#...............%%%.....#
#..............%%%......#
|@.............%%%..!...|
#..............%%%......#
#.......................#
#.......................#
#.......................#
#.....%%%...............#
#.....%%%%..............#
#......%%...............#
#..........!............#
#.......................#
#########################
