#########################
#.......................#
#.......................#
#....!.%%%%%............#
#.....%%%%%%............#
#....%%.................#
#...%%..................#
#...%%..................#
#..%%...................#
#..%....................#
|@......................|
#...................%...#
#..................%%...#
#.................%%%...#
#................%%%....#
#...............%%%.....#
#..............%%%..!...#
#...........%%%%........#
#.......................#
#.......................#
#########################
