#########################
#.......................#
#........!..............#
#...%%%%.........%%%....#
#..%%%%%.........%%.....#
#.......................#
#.......................#
#.......................#
#.......................#
#.........%.........%...#
|.@.......%%.......%%.!.|
#...................%...#
#.......................#
#.......................#
#...%...................#
#...%%........%%........#
#...%%........%%%%%.....#
#..............%%%......#
#.................!.....#
#.......................#
#########################
