#########################
#.......................#
#..........%%%%.........#
#.......................#
#....................!..#
#.......................#
#.......%%......%.......#
#......%%........%%.....#
#.....%............%%...#
#.....%.....!.......%...#
|@....%%...........%%...|
#......%.%......%%%.....#
#......%%%.....%%.......#
#...............%.......#
#.......................#
#.......................#
#........%%.............#
#........%%%%.......!...#
#...........%...........#
#.......................#
#########################
