#########################
#.......................#
#.......................#
#......!...........!....#
#.......................#
#....%%%%........%%%%...#
#....%%..........%%%....#
#....%.............%....#
#.......................#
#.......................#
|.@.....................|
#.......................#
#.......................#
#................%%.....#
#..%%...........%%%.....#
#..%.%..........%%......#
#.%%%%%..........%..!...#
#..%%%%.................#
#.........!.............#
#.......................#
#########################
