#########################
#.......................#
#...........!...........#
#.......................#
#....%%%%%%%%%%%%%%%....#
#....%%%%%%%%%%%%%%%%...#
#.......................#
#.......................#
#.......................#
#.......................#
|@..........!...........|
#.......................#
#.......................#
#.......................#
#....%%%%%%%%%%%%%%%%...#
#.....%%%%%%%%%%%%%%....#
#.......................#
#...........!...........#
#.......................#
#.......................#
#########################
