#########################
#.......................#
#........!..............#
#.......................#
#......%..........%%..!.#
#.....%%%........%%%....#
#.....%%.........%%%%...#
#..................%%...#
#.......................#
#.......................#
|@..........%...........|
#.........%%............#
#........%..............#
#.......%...............#
#......%................#
#...%%%...!.............#
#...%%%.......%%%.......#
#...%%%.......%%%%......#
#.......................#
#.......................#
#########################
