#########################
#.......................#
#.......................#
#......!................#
#...%%..................#
#...%%%............%%...#
#..................%%.!.#
#..................%%...#
#.................%.....#
#.......................#
|.@......%%.............|
#........%%%%...........#
#.........%%%...........#
#........%..............#
#.......................#
#.......................#
#...%%%.............%...#
#...%.%.............%%..#
#.......................#
#.......................#
#########################
