#########################
#.......................#
#.......................#
#......!...........!....#
#.......................#
#....%%%%........%%%%...#
#....%%..........%%%....#
#....%.............%....#
#.......................#
#.......................#
|@......................|
#.......................#
#.......................#
#................%%.....#
#..%%...........%%%.....#
#..%.%..........%%......#
#.%%%%%..........%..!...#
#..%%%%.................#
#.......................#
#.....!.................#
#########################
