#########################
#.......................#
#.............!....%....#
#.................%%....#
#......%%%%%%%%...%%....#
#....%%.......%...%%....#
#...........%%%.........#
#........%%%.....%......#
#................%......#
#.................%.....#
|@................%.....|
#.................%..!..#
#.................%.....#
#.................%.....#
#........%%.............#
#......%%....%..........#
#......%%.%%%..!...%....#
#.......................#
#.......................#
#.......................#
#########################
